1111111111111
100100E000001
1000011111001
00C01100P0000
1111111111111