1111111111
1000000001
10P0000001
1001E00C01
1111111111