1111111111
100C000001
1P00000C01
1C01E00001
1111111111