1111111111111
1C0100E000001
1000011111001
10CCC100P0001
1111111111111