1111111111
1000000001
10P010R001
1001E00C01
1001C00C01
1111111111